{
    "maps": {
        "map_1" :{
            "Name": "Firts Level",
            "ID": 0,
            "Width": 10,
            "Height": 10,
            "Data": [
                [4, 4, 4, 4, 4, 4, 4, 4, 4, 4],
                [4, 4, 4, 4, 4, 4, 4, 4, 4, 4],
                [4, 0, 1, 1, 1, 1, 1, 1, 2, 4],
                [4, 6, 7, 7, 7, 7, 7, 7, 8, 4],
                [4, 6, 7, 7, 7, 7, 7, 7, 8, 4],
                [4, 6, 7, 7, 7, 7, 7, 7, 8, 4],
                [4, 6, 7, 7, 7, 7, 7, 7, 8, 4],
                [4, 11, 12, 12, 12, 12, 12, 12, 13, 4],
                [4, 4, 4, 4, 4, 4, 4, 4, 4, 4],
                [4, 4, 4, 4, 4, 4, 4, 4, 4, 4]
            ]
        },
        "map_2" :{
            "Name": "Second Level",
            "ID": 1,
            "Width": 10,
            "Height": 10,
            "Data": [
                [-1, -1, -1, 9, -1, -1, -1, -1, -1, -1],
                [-1, -1, -1, -1, -1, -1, -1, -1, -1, -1],
                [9, -1, -1, -1, -1, -1, -1, -1, -1, -1],
                [-1, -1, -1, -1, -1, -1, -1, -1, -1, 5],
                [-1, -1, -1, -1, -1, -1, -1, -1, -1, 10],
                [-1, -1, -1, -1, -1, -1, -1, -1, -1, -1],
                [-1, -1, -1, -1, -1, -1, -1, -1, -1, -1],
                [-1, -1, -1, -1, -1, -1, -1, 5, -1, -1],
                [-1, -1, 9, -1, -1, -1, -1, 10, -1, -1],
                [-1, -1, 9, -1, -1, -1, 9, -1, -1, -1]                
            ]
        }
    }
}